0,1,0,0,0,0,0,0,6L,0,0,0,0,0,0,0,0,0,0,0,
0,0,0,0,0,0,0,0,6R,0,1,0,0,0,0,0,0,0,0,0,
0,0,0,0,0,0,0,0,0,0,0,0,0,0,0,0,0,0,0,0,
0,0,0,0,5,4,0,0,0,0,0,0,0,0,0,0,1,0,0,0,
0,0,0,0,5,4,0,0,0,0,0,0,0,0,0,0,1,0,0,0,
0,0,0,0,5,4,0,0,0,0,0,0,0,0,1,0,1,0,0,0,
0,0,0,0,5,0,0,0,0,1,0,1,0,1,1,0,1,0,0,0,
0,0,3,0,5,0,0,0,0,0,1,0,0,0,1,0,1,0,2,0,
1,1,1,1,1,1,1,1,1,1,1,1,1,1,1,1,1,1,1,1