0,0,0,0,0,0,0,0,0,0,0,0,0,0,0,0,0,0,0
0,0,0,0,0,0,0,0,0,0,0,0,0,0,0,0,0,0,0
0,0,0,0,0,0,0,0,0,0,0,0,0,0,0,0,0,0,0
0,0,0,0,0,1,1,1,0,0,1,1,1,0,0,0,0,0,0
0,0,0,0,5,0,5,0,1,1,2,1,0,1,0,0,0,0,0
0,0,0,5,0,5,0,5,0,0,1,0,1,0,1,0,0,0,0
0,0,5,0,5,0,5,0,0,0,0,1,0,1,0,1,0,0,0
0,5,3,5,0,5,0,5,0,0,1,0,1,0,1,0,0,0,0
1,1,1,1,1,1,1,1,1,1,1,1,1,1,1,1,1,1,1