1,0,0,5,5,5,5,5,0,1,1,0,0,0,1
1,0,0,5,5,5,5,5,0,1,1,0,0,0,1
1,0,0,5,5,5,5,5,0,1,1,0,0,0,1
1,0,0,5,5,5,5,5,0,1,1,0,0,0,1
1,0,0,5,5,5,5,5,0,1,1,0,0,0,1
1,0,0,5,5,5,5,5,0,1,1,0,0,0,1
1,0,0,5,5,5,5,5,0,1,1,0,0,0,1
1,0,3,5,5,5,5,5,0,1,1,0,2,0,1
1,1,1,1,1,1,1,1,1,1,1,1,1,1,1