0,0,0,5,5,5,5,0,0,0,0,0,0,0,0,0,0,0,0
0,0,0,5,5,5,5,0,1,0,1,0,0,0,0,0,0,0,0
0,0,0,5,5,5,5,0,1,1,1,0,0,0,0,0,0,0,0
0,0,0,5,5,5,5,0,1,0,1,0,0,0,0,0,0,0,0
0,0,0,1,5,5,5,0,1,1,1,0,0,0,0,0,0,0,0
0,0,0,5,5,5,5,0,1,0,1,0,0,0,0,0,0,0,0
0,0,0,1,1,5,5,0,1,1,1,0,0,0,0,0,0,0,0
0,0,3,5,5,5,5,0,1,0,1,0,0,6L,0,0,2,0,0
1,1,1,1,1,1,1,1,1,1,1,1,1,1,1,1,1,1,1